1111111111
1P000C0001
1110000001
1C000C00C1
1000000001
1001111011
1C1ECCCCC1
1111111111